    ####
  ###.####
 ##...#  ###
 #  $      #
## $ $   $ ##
# $#$    #$ #
#@ $  ## $  #
#####....  ##
    ### .###
      ####
