#####
#   #
# $ #
#   #
#   #
#   ##
#     #
# @*. #
#     #
#     #
######