##########
#.#      #
# #@$ $  #
# #      #
#.#####  #
#        #
#        #
##########
