    ####
  ###.####
 ##...#  ###
 #  $      #
## $ $   $ ##
# $#$    #$ #
#@ $  ## $  #
#####....  ##
    ### .###
      ####

    ####
  ###.####
 ##...#  ###
 #  $      #
## $ $   $ ##
#@$#$    #$ #
#  $  ## $  #
#####....  ##
    ### .###
      ####

    ####
  ###.####
 ##...#  ###
 #  $      #
## $ $   $ ##
# $#$    #$ #
# @$  ## $  #
#####....  ##
    ### .###
      ####

    ####
  ###.####
 ##...#  ###
 #  $      #
##$$ $   $ ##
# @#$    #$ #
#  $  ## $  #
#####....  ##
    ### .###
      ####

    ####
  ###.####
 ##...#  ###
 #  $      #
## $ $   $ ##
# $#$    #$ #
#  @$ ## $  #
#####....  ##
    ### .###
      ####

    ####
  ###.####
 ##...#  ###
 #$ $      #
##@$ $   $ ##
#  #$    #$ #
#  $  ## $  #
#####....  ##
    ### .###
      ####

    ####
  ###.####
 ##...#  ###
 #  $      #
##$$ $   $ ##
#  #$    #$ #
# @$  ## $  #
#####....  ##
    ### .###
      ####

    ####
  ###.####
 ##...#  ###
 #  $      #
##$$ $   $ ##
#@ #$    #$ #
#  $  ## $  #
#####....  ##
    ### .###
      ####

    ####
  ###.####
 ##...#  ###
 #  $      #
## $ $   $ ##
# $#$    #$ #
# @ $ ## $  #
#####....  ##
    ### .###
      ####

    ####
  ###.####
 ##...#  ###
 #  $      #
## $ $   $ ##
# $#$    #$ #
#   @$## $  #
#####....  ##
    ### .###
      ####

    ####
  ###.####
 ##...#  ###
 #  $      #
##$$ $   $ ##
#  #$    #$ #
#@ $  ## $  #
#####....  ##
    ### .###
      ####

    ####
  ###.####
 ##...#  ###
 #  $      #
##$$ $   $ ##
#  #$    #$ #
#  @$ ## $  #
#####....  ##
    ### .###
      ####

    ####
  ###.####
 ##...#  ###
 #  $      #
##$$ $   $ ##
# @#$    #$ #
#   $ ## $  #
#####....  ##
    ### .###
      ####

    ####
  ###.####
 ##...#  ###
 #  $      #
## $ $   $ ##
# $#$    #$ #
#@  $ ## $  #
#####....  ##
    ### .###
      ####

    ####
  ###.####
 ##...#  ###
 #  $      #
## $$$   $ ##
# $#@    #$ #
#    $## $  #
#####....  ##
    ### .###
      ####

    ####
  ###.####
 ##...#  ###
 #  $      #
## $ $   $ ##
# $#$    #$ #
#  @ $## $  #
#####....  ##
    ### .###
      ####

    ####
  ###.####
 ##...#  ###
 #  $      #
##$$ $   $ ##
#  #$    #$ #
# @ $ ## $  #
#####....  ##
    ### .###
      ####

    ####
  ###.####
 ##...#  ###
 #  $      #
##$$ $   $ ##
#  #$    #$ #
#   @$## $  #
#####....  ##
    ### .###
      ####

    ####
  ###.####
 ##...#  ###
 #$ $      #
##@$ $   $ ##
#  #$    #$ #
#   $ ## $  #
#####....  ##
    ### .###
      ####

    ####
  ###.####
 ##...#  ###
 #  $      #
##$$ $   $ ##
#@ #$    #$ #
#   $ ## $  #
#####....  ##
    ### .###
      ####

    ####
  ###.####
 ##...#  ###
 #  $      #
## $ $   $ ##
#@$#$    #$ #
#   $ ## $  #
#####....  ##
    ### .###
      ####

    ####
  ###.####
 ##...#  ###
 #  $      #
## $ $   $ ##
# $#$    #$ #
# @  $## $  #
#####....  ##
    ### .###
      ####

    ####
  ###.####
 ##...#  ###
 #  $      #
##$$ $   $ ##
#  #$    #$ #
#@  $ ## $  #
#####....  ##
    ### .###
      ####

    ####
  ###.####
 ##...#  ###
 #  $      #
##$$$$   $ ##
#  #@    #$ #
#    $## $  #
#####....  ##
    ### .###
      ####

    ####
  ###.####
 ##...#  ###
 #  $      #
##$$ $   $ ##
#  #$    #$ #
#  @ $## $  #
#####....  ##
    ### .###
      ####

    ####
  ###.####
 ##...#  ###
 #  $      #
##$$ $   $ ##
# @#$    #$ #
#    $## $  #
#####....  ##
    ### .###
      ####

    ####
  ###.####
 ##...#  ###
 #  $      #
## $ $   $ ##
# $#$    #$ #
#@   $## $  #
#####....  ##
    ### .###
      ####

    ####
  ###.####
 ##...#  ###
 #  $      #
##$$ $   $ ##
#  #$    #$ #
# @  $## $  #
#####....  ##
    ### .###
      ####

    ####
  ###.####
 ##...#  ###
 #$ $      #
##@$ $   $ ##
#  #$    #$ #
#    $## $  #
#####....  ##
    ### .###
      ####

    ####
  ###.####
 ##...#  ###
 #  $      #
##$$ $   $ ##
#@ #$    #$ #
#    $## $  #
#####....  ##
    ### .###
      ####

    ####
  ###.####
 ##...#  ###
 #  $      #
## $ $   $ ##
#@$#$    #$ #
#    $## $  #
#####....  ##
    ### .###
      ####

    ####
  ###.####
 ##...#  ###
 #  $      #
##$$ $   $ ##
#  #$    #$ #
#@   $## $  #
#####....  ##
    ### .###
      ####


